
NO ./truc muche1

SD ./truc muche2

WE               ./truc muche3

EA ./truc                  muche   				  
        


    		F          220,               100,             0


C 225, 30, 0














11111111111111111111111111
      111000100000000000011111
111111000000000000111000100001
110000100000000000000000001111
100001111111000000010000111111
1111111000000000W0000000000001
111100000000001100000001000011
110000000000011110000000000011
10000000000011100000000000011
110000000000111000000000001111
110000000001111000000000000111
111111111111111111111111111111111