NO ./texture/mur_b.xpm
SO ./texture/mur_d.xpm
WE ./texture/mur_d2.xpm
EA ./texture/mur_m.xpm

F 255, 0, 255
C 50, 0, 50

111111111111111
100000000000001
100000000000001
1W0000010000001
100000000000001
100000000000001
111111111111111
