NO ./truc muche
SD ./truc muche1
WE ./truc muche2
EA ./truc muche3

F 220, 100, 0
C 225, 30, 0


     1111111 111111
1111110000001000001
100000111110111000011
11100000010000100001
  10000001111010000111
111000W0000000100001
11111000111111100001
     101  11100101111
      1     111111