     1111111 111111
1111110000001000001
10000000000000000011
11100000000000000001
  10000000000000000111
11100000000000000001
11111000110000000001
     101  1111111111
      1     111111