NO ./truc muche
SD ./truc muche
WE ./truc muche
EA ./truc muche

F 220, 100, 0
C 225, 30, 0

1111111 11111111
100000010000001
100000000000001
11111111 1111111