NO ./texture/mur_b.xpm
SO ./texture/mur_d.xpm
WE ./texture/LE_J.xpm
EA ./texture/mur_m.xpm

F 90, 90, 90
C 128, 128, 128



     1111111 111111
1111110000001000001
100001111110111000011
11100000010000000001
  1001000111101000111
111000W0000000100001
11111000111111100001
     101  11101101111
      1     111111