NO ./truc muche
SD ./truc muche
WE ./truc muche
EA ./truc muche

F 245, 256, 0
C 225, 30, 0

1111111 11111111
100000010000001
100000000000001
1111111111111111