NO ./texture/mur_b.xpm
SO ./texture/mur_d.xpm
WE ./texture/mur_d2.xpm
EA ./texture/mur_m.xpm

F 255, 0, 255
C 50, 0, 50



        111111111111111111111111111111111111111111111111111111111111111111111111111111111111111111111111111111111 
         100000000011000000000000101010110101010001010101101010101010111111111111111111111111111111111111111111111 
         10110000011100000000000011111011111111101110101001000000110111                                          1 
         10010000000000000000000011111011111111101110101001000110110111111111111111111       111111111111111111111 
 111111111011000001110000000000001    1         1 1 1 1 11 111 101 1                11               1    
 100000000011000001110111111111111                1            101                  11       111111111 
 11110111111111011100000010001111111111111111111111111111111111101111111111111111111111111111111111111 
 11110111111111011101010010000000000000000000000000000000000000000000000000000000000000000000000000E01 
 11000000110101011100000010000011111111111111111111111111111111111111111111111111111111111111111111111 
 100000000000000000000000000011                   1 
 10000000000000001101010010001                    1 
 11000001110101011111011110101111111111111111111111 
 11110111 1110101 10111101000100000000000000001 
 1   1       1 1   1    1 111 11111111111111111