NO ./truc muche
SD ./truc muche
WE ./truc muche
EA ./truc muche

F 220, 100, 0
C 225, 30, 0

111111111111111
111111000111111
111111000111111
100000000000001
100000000000001
111111000111111
111111000111111
111111111111111