NO ./texture/mur_b.xpm
SO ./texture/mur_d.xpm
F 245, 255, 0




WE ./texture/mur_d2.xpm
EA ./texture/mur_m.xpm

C 225, 30, 0

  
  
  
                   111111            
         1111111111100001111111111   
         1000000000110000000000001   
         101100000111001111100000111 
         100100000000001   100000001 
 111  111101100000111001   100000001 
 10111100001100000111001   101111111 
 11110111111111011100001   101       
 11110111111111011101001111101       
 11000001111111011100000010001       
 10000001    10001100N00010001       
 10000001111110001101010010001       
 1100000111010101111101111000111     
 11110111 1110101 101111010001       
 11111111 1111111 111111011111       
                        1    