NO ./texture/mur_b.xpm
SD ./texture/mur_d.xpm
WE ./texture/mur_d2.xpm
EA ./texture/mur_m.xpm

F 245, 255, 0
C 225, 30, 0

1111111 11111111
1000000100000011
1S00000000000011
1111111111111111