NO ./truc muche1
SD ./truc muche2
WE ./truc muche3
EA ./truc muche4

F 245, 255, 0
C 225, 30, 0

1111111 11111111
10N000010000001
100000000000001
1111111111111111