NO ./truc muche
SD ./truc muche
WE ./truc muche
EA ./truc muche

F 220, 100, 0
C 225, 30, 0


     1111111 111111
1111110000001000001
100000111110000000011
11100000010000000001
  10000001111000000111
11100000000000000001
11111000110000000001
     101  11100101111
      1     111111