NO ./truc muche1
SD ./truc muche2
WE ./truc muche3
EA ./truc muche4

F 220, 100, 0
C 225, 30, 0

111111111111111
111111000111111
111111000111111
111111000111111
111000000000111
111N00000000111
111000000000111
111111000111111
111111000111111
111111000111111
111111111111111