NO ./truc muche1
SD ./truc muche2
WE ./truc muche3
EA ./truc muche4

F 245, 255, 0
C 225, 30, 0

111111111111111
100000000000001
100000000000001
10E000010000001
100000000000001
100000000000001
111111111111111