NO ./truc muche
SD ./truc muche
WE ./truc muche
EA ./truc muche

F 245, 255, 0
C 225, 30, 0

1111111 11111111
1000000100000011
1000000000000011
1111111111111111